OOOOOOOO
OR  O  O
O  BBB O
OSS    O
OOOOOOOO