OOOOOOOOOOO
ORSS  OO  O
O B B OO  O
OO O SOO  O
O B OOO  OO
O   B     O
O   OOO   O
OOOOO OOOOO