OOOOOOOOOOO
O   O     O
O   O     O
O   OOO B O
O  O  OOSSO
O B  BRB  O
O     O SOO
OOOOOOOOOO